11111111
11100011
13620011
11102311
13112011
10103011
12042231
10003001
11111111